1111111111
1000100001
1000100001
1000100001
1010100001
1000001001
1000001001
1111111001
1000000001
1000000001
1000001111
1001001$01
1001001001
1001000001
1111111111